10 7  
6  2
##########          
#  ###   #
#  #     #
#        #
#        #
#        #
## #######         
